12:12
0 0 0 0 0 0 0 96 0 0 0 55
0 18 0 18 0 18 0 18 0 18 0 18
32 0 0 18 0 18 0 18 0 18 0 18
0 0 18 18 17 32 32 32 17 18 18 0
32 0 0 0 0 0 0 35 36 0 0 0
0 18 0 18 0 18 0 36 0 35 0 18
0 0 18 0 18 0 18 0 18 0 18 0
0 18 0 0 0 0 0 0 0 0 96 0
0 18 18 18 0 0 18 18 18 0 0 0
35 0 0 17 0 17 32 96 0 0 0 0
0 0 0 0 0 0 0 0 0 0 0 0
59 17 17 17 17 17 17 17 17 17 17 17
