12:12
0 35 35 0 0 34 0 0 0 0 0 0
36 17 17 17 17 17 17 17 17 17 18 0
36 0 0 0 0 0 0 0 0 64 51 0
36 17 17 17 17 17 17 17 17 17 18 0
0 0 36 36 0 0 32 0 0 0 0 0
0 0 96 0 0 0 0 0 0 0 0 0
55 0 0 0 17 17 0 0 0 0 0 0
96 0 0 0 0 0 0 0 0 0 0 0
0 0 0 35 0 0 0 35 0 0 0 0
18 18 17 0 17 18 18 0 0 0 0 0
0 0 0 0 0 0 0 0 0 0 0 0
0 18 0 18 18 18 18 18 18 0 0 0
