12:12
17 17 17 17 17 17 17 17 0 0 0 0
17 34 0 0 0 0 0 0 35 0 35
17 0 0 17 17 17 17 17 0 0 53 0
17 0 0 18 18 18 17 17 0 0 0 0
17 0 96 0 34 64 18 17 17 0 0 0
17 37 0 0 18 18 18 17 17 96 0 0
17 35 0 18 0 0 0 0 0 0 0 0
17 34 0 0 0 0 0 0 0 0 0 0
18 0 17 0 0 0 0 0 18 18 18 18
18 0 17 17 17 0 18 0 0 0 0 0
18 0 0 0 0 0 0 0 18 18 0 18
34 0 49 0 0 0 0 0 0 0 17 18
