12:12
61 0 0 0 0 0 0 0 0 0 0 0
0 0 0 0 0 0 0 0 0 0 0 0
0 0 0 0 0 0 0 0 0 0 0 0
32 32 0 32 32 32 32 32 96 96 0 0
32 32 0 32 0 0 0 0 0 0 0 0
32 32 0 32 32 32 32 32 32 32 32 32
0 0 0 18 0 17 0 0 0 0 0 0
0 0 0 17 0 18 0 0 0 0 0 0
0 0 0 18 0 17 0 96 0 0 0 0
0 0 0 17 0 18 96 0 96 0 0 0
0 0 0 18 0 17 0 96 0 0 0 0
0 0 0 17 128 18 0 0 0 0 0 0
