12:12
57 32 36 0 0 0 0 0 0 32 32 17
17 96 17 17 17 17 17 17 17 17 17 17
32 32 0 0 0 0 0 0 35 0 0 0
0 96 17 17 17 17 17 17 17 17 17 17
0 0 0 0 0 0 0 35 17 0 0 0
0 96 17 17 17 17 17 17 17 17 17 17
0 0 0 17 17 17 0 0 0 0 0 0
17 17 0 17 17 18 17 0 0 0 0 0
0 0 0 17 17 17 0 0 0 37 0 0
0 17 17 17 17 17 17 17 17 17 96 0
0 32 17 17 17 17 17 0 96 0 0 0
0 32 0 0 0 0 0 0 0 0 0 53
