12:12
63 0 0 0 0 0 0 0 0 0 0 0
0 0 0 0 0 0 96 0 0 0 0 0
0 0 0 0 0 0 0 0 0 0 0 0
32 32 32 32 32 32 32 0 0 0 0 0
32 32 32 32 32 32 32 32 0 0 0 0
32 32 32 32 32 32 32 0 0 0 0 0
32 32 32 17 0 17 32 32 0 0 0 0
32 32 32 0 0 0 32 32 32 0 0 0
32 32 32 17 0 17 32 32 0 0 0 0
96 32 32 32 32 32 32 0 0 0 0 0
0 0 0 32 32 32 32 32 0 0 0 0
0 0 0 0 0 0 0 0 0 0 0 59 
