12:12
57 17 0 0 0 0 0 0 0 0 32 61
0 17 0 0 0 0 0 0 0 0 32 32
32 17 0 96 0 0 0 0 0 0 32 32
0 0 0 0 0 32 32 32 0 0 0 0
0 0 0 0 0 0 32 32 32 0 0 0
0 0 0 0 0 0 0 0 0 0 0 0
0 0 0 18 17 18 17 18 0 0 0 0
0 0 0 17 61 17 18 0 0 96 0 0
0 0 0 17 0 18 0 0 0 0 0 0
0 0 0 17 0 18 0 0 0 0 0 0
0 0 0 0 0 0 0 0 0 0 0 0
0 0 0 0 0 0 0 0 96 0 0 0
